20,3
6	6	6	6	6	6	6	6	6	6	6	6	6	6	6	6	6	6	6	6
6	6	6	6	6	6	6	6	6	6	6	6	6	6	6	6	6	6	6	6
6	6	6	6	6	6	6	6	6	6	6	6	6	6	6	6	6	6	6	6
6	6	6	6	6	6	6	6	6	6	6	6	6	6	6	6	6	6	6	6
6	6	6	6	6	6	6	6	6	6	6	6	6	6	6	6	6	6	6	6
6	6	6	6	6	6	6	6	6	6	6	6	6	6	6	6	6	6	6	6
6	6	6	6	6	6	6	1	1	1	1	1	1	6	6	6	6	6	6	6
6	6	6	6	6	6	6	1	0	0	0	0	1	1	6	6	6	6	6	6
6	6	6	6	6	6	1	1	2	1	1	3	0	1	6	6	6	6	6	6
6	6	6	6	6	6	1	0	2	2	3	0	0	1	6	6	6	6	6	6
6	6	6	6	6	6	1	0	0	1	3	0	0	1	6	6	6	6	6	6
6	6	6	6	6	6	1	0	0	4	0	1	1	1	6	6	6	6	6	6
6	6	6	6	6	6	1	1	1	1	1	1	6	6	6	6	6	6	6	6
6	6	6	6	6	6	6	6	6	6	6	6	6	6	6	6	6	6	6	6
6	6	6	6	6	6	6	6	6	6	6	6	6	6	6	6	6	6	6	6
6	6	6	6	6	6	6	6	6	6	6	6	6	6	6	6	6	6	6	6
6	6	6	6	6	6	6	6	6	6	6	6	6	6	6	6	6	6	6	6
6	6	6	6	6	6	6	6	6	6	6	6	6	6	6	6	6	6	6	6
6	6	6	6	6	6	6	6	6	6	6	6	6	6	6	6	6	6	6	6
6	6	6	6	6	6	6	6	6	6	6	6	6	6	6	6	6	6	6	6
11,9
