20,3
6	6	6	6	6	6	6	6	6	6	6	6	6	6	6	6	6	6	6	6
6	6	6	6	6	6	6	6	6	6	6	6	6	6	6	6	6	6	6	6
6	6	6	6	6	6	6	6	6	6	6	6	6	6	6	6	6	6	6	6
6	6	6	6	6	6	6	6	6	6	6	6	6	6	6	6	6	6	6	6
6	6	6	6	6	6	6	6	6	6	6	6	6	6	6	6	6	6	6	6
6	6	6	6	6	6	6	6	6	6	6	6	6	6	6	6	6	6	6	6
6	6	6	6	6	6	1	1	1	1	1	1	1	1	6	6	6	6	6	6
6	6	6	6	6	6	1	0	0	0	0	0	0	1	6	6	6	6	6	6
6	6	6	6	6	6	1	0	0	0	0	0	0	1	6	6	6	6	6	6
6	6	6	6	6	6	1	0	0	4	0	0	0	1	6	6	6	6	6	6
6	6	6	6	6	6	1	0	0	3	3	3	0	1	6	6	6	6	6	6
6	6	6	6	6	6	1	0	0	0	2	2	2	1	6	6	6	6	6	6
6	6	6	6	6	6	1	0	0	0	0	0	0	1	6	6	6	6	6	6
6	6	6	6	6	6	1	1	1	1	1	1	1	1	6	6	6	6	6	6
6	6	6	6	6	6	6	6	6	6	6	6	6	6	6	6	6	6	6	6
6	6	6	6	6	6	6	6	6	6	6	6	6	6	6	6	6	6	6	6
6	6	6	6	6	6	6	6	6	6	6	6	6	6	6	6	6	6	6	6
6	6	6	6	6	6	6	6	6	6	6	6	6	6	6	6	6	6	6	6
6	6	6	6	6	6	6	6	6	6	6	6	6	6	6	6	6	6	6	6
6	6	6	6	6	6	6	6	6	6	6	6	6	6	6	6	6	6	6	6
3,3
