20,6
6	6	6	6	6	6	6	6	6	6	6	6	6	6	6	6	6	6	6	6
6	6	6	6	6	6	6	6	6	6	6	6	6	6	6	6	6	6	6	6
6	6	6	6	6	6	6	6	6	6	6	6	6	6	6	6	6	6	6	6
6	6	6	6	6	6	6	6	6	6	6	6	6	6	6	6	6	6	6	6
6	6	6	6	6	6	6	6	6	6	6	6	6	6	6	6	6	6	6	6
6	6	6	6	6	1	1	1	1	6	6	6	6	6	6	6	6	6	6	6
6	6	6	6	6	1	0	0	1	1	1	1	1	1	1	6	6	6	6	6
6	6	6	6	6	1	0	0	2	0	0	0	0	0	1	6	6	6	6	6
6	6	6	6	6	1	0	0	1	3	3	3	3	3	1	6	6	6	6	6
6	6	6	6	6	1	0	1	1	2	2	2	2	2	1	6	6	6	6	6
6	6	6	6	6	1	0	0	1	0	0	3	0	0	1	6	6	6	6	6
6	6	6	6	6	1	1	0	1	1	1	1	0	1	1	6	6	6	6	6
6	6	6	6	6	1	0	0	0	0	0	0	0	0	1	6	6	6	6	6
6	6	6	6	6	1	0	0	0	1	1	0	0	4	1	6	6	6	6	6
6	6	6	6	6	1	1	1	1	1	1	1	1	1	1	6	6	6	6	6
6	6	6	6	6	6	6	6	6	6	6	6	6	6	6	6	6	6	6	6
6	6	6	6	6	6	6	6	6	6	6	6	6	6	6	6	6	6	6	6
6	6	6	6	6	6	6	6	6	6	6	6	6	6	6	6	6	6	6	6
6	6	6	6	6	6	6	6	6	6	6	6	6	6	6	6	6	6	6	6
6	6	6	6	6	6	6	6	6	6	6	6	6	6	6	6	6	6	6	6
13,13

