20,6
6	6	6	6	6	6	6	6	6	6	6	6	6	6	6	6	6	6	6	6
6	6	6	6	6	6	6	6	6	6	6	6	6	6	6	6	6	6	6	6
6	6	6	6	6	6	6	6	6	6	6	6	6	6	6	6	6	6	6	6
6	6	6	6	6	6	6	6	6	6	6	6	6	6	6	6	6	6	6	6
6	6	6	1	1	1	1	6	6	6	6	6	6	6	6	6	6	6	6	6
6	6	6	1	0	0	1	1	1	1	1	1	6	6	6	6	6	6	6	6
6	6	6	1	0	3	0	0	3	0	0	1	6	6	6	6	6	6	6	6
6	6	6	1	0	0	1	1	0	0	0	1	6	6	6	6	6	6	6	6
6	6	6	1	0	0	2	2	1	0	1	1	6	6	6	6	6	6	6	6
6	6	6	1	0	3	2	2	1	3	1	1	6	6	6	6	6	6	6	6
6	6	6	1	1	0	2	2	1	0	0	1	6	6	6	6	6	6	6	6
6	6	6	1	0	0	1	1	0	0	0	1	6	6	6	6	6	6	6	6
6	6	6	1	0	3	0	0	3	0	0	1	6	6	6	6	6	6	6	6
6	6	6	1	0	4	1	1	1	1	1	1	6	6	6	6	6	6	6	6
6	6	6	1	1	1	1	6	6	6	6	6	6	6	6	6	6	6	6	6
6	6	6	6	6	6	6	6	6	6	6	6	6	6	6	6	6	6	6	6
6	6	6	6	6	6	6	6	6	6	6	6	6	6	6	6	6	6	6	6
6	6	6	6	6	6	6	6	6	6	6	6	6	6	6	6	6	6	6	6
6	6	6	6	6	6	6	6	6	6	6	6	6	6	6	6	6	6	6	6
6	6	6	6	6	6	6	6	6	6	6	6	6	6	6	6	6	6	6	6
13,5
